The Quarrel
An Interactive Fiction by Zane Mariano & Jon Gill
Release 1 / Serial number 130306 / Inform 7 build 6G60 (I6/v6.32 lib 6/12N) SD

The Closet: Trapped
You wake up in a room surrounded by shit and stuff. It's also pretty dark in here. Sucks.

>l
The Closet: Trapped

>x
What do you want to examine?

>m
You can't see any such thing.

>l
The Closet: Trapped

* * *

The Quarrel
An Interactive Fiction by Zane Mariano & Jon Gill
Release 1 / Serial number 130306 / Inform 7 build 6G60 (I6/v6.32 lib 6/12N) SD

The Closet: Trapped
You wake up in a room surrounded by shit and stuff. It's also pretty dark in here. Sucks.

>x me
As good-looking as ever.

>l
The Closet: Trapped
You wake up in a room surrounded by shit and stuff. It's also pretty dark in here. Sucks.

* * *

The Quarrel
An Interactive Fiction by Zane Mariano & Jon Gill
Release 1 / Serial number 130306 / Inform 7 build 6G60 (I6/v6.32 lib 6/12N) SD

The Closet: Trapped
You wake up in a room surrounded by shit and stuff. It's also pretty dark in here. Sucks.

>rewind
Yes, yes, that's not how it happened.
 No! Yes it was! Are you sure you want to rewind?

>l
Please answer yes or no.

>x me
Please answer yes or no.

>exmine me
Please answer yes or no.

>examine me
Please answer yes or no.

>examine
Please answer yes or no.

>x
Please answer yes or no.

>look
Please answer yes or no.

>l
Please answer yes or no.

>inventory
Please answer yes or no.

>i
Please answer yes or no.

>e
Please answer yes or no.

>s
Please answer yes or no.

>w
Please answer yes or no.

Please answer yes or no.

>x me
Please answer yes or no.

>x me
Please answer yes or no.

>yes
Here we go!

>rewind
Yes, yes, that's not how it happened.
 No! Yes it was! Are you sure you want to rewind?

>y
Here we go!

>rewind
Yes, yes, that's not how it happened.
 No! Yes it was! Are you sure you want to rewind?

>f
Please answer yes or no.

>e
Please answer yes or no.

>r
Please answer yes or no.

>t
Please answer yes or no.

>y
Here we go!

>h
That's not a verb I recognise.

>rewind
Yes, yes, that's not how it happened.
 No! Yes it was! Are you sure you want to rewind?

>y
-1

>fastforward
FastForwarding...

0

>fastforward
FastForwarding...

1

>fastforward
FastForwarding...

2

>fastforward
FastForwarding...

3

>rewind
Yes, yes, that's not how it happened.
 No! Yes it was! Are you sure you want to rewind?

>y
2

>rewind
Yes, yes, that's not how it happened.
 No! Yes it was! Are you sure you want to rewind?

>y
1

>rewind
Yes, yes, that's not how it happened.
 No! Yes it was! Are you sure you want to rewind?

>y
0

* * *

The Quarrel
An Interactive Fiction by Zane Mariano & Jon Gill
Release 1 / Serial number 130306 / Inform 7 build 6G60 (I6/v6.32 lib 6/12N) SD

The Closet: Trapped
You wake up in a room surrounded by shit and stuff. It's also pretty dark in here. Sucks.

>j
That's not a verb I recognise.

>jump
You jump on the spot, fruitlessly.

Yes, yes, that's not how it happened.
 No! Yes it was! Are you sure you want to rewind?

* * *

>go
You'll have to say which compass direction to go in.

Yes, yes, that's not how it happened.
 No! Yes it was! Are you sure you want to rewind?

* * *

>transitioning
What do you want to transitio?

>transit
You can't see any such thing.

>transition
What do you want to transitio?

>transitioning
What do you want to transitio?

>progress room3
You can't see any such thing.

* * *

The Quarrel
An Interactive Fiction by Zane Mariano & Jon Gill
Release 1 / Serial number 130306 / Inform 7 build 6G60 (I6/v6.32 lib 6/12N) SD

The Closet: Trapped
You wake up in a room surrounded by shit and stuff. It's also pretty dark in here. Sucks.

>fastforward
FastForwarding...

1

>rewind
Yes, yes, that's not how it happened.
 No! Yes it was! Are you sure you want to rewind?

* * *

>y
0

>rewind
Yes, yes, that's not how it happened.
 No! Yes it was! Are you sure you want to rewind?

* * *

>y
-1

I beg your pardon?